*********
* ***** *
* ***** *
* ***** *
* ***** *
*       *
* ***** *
* ***** *
* ***** *
*********
